11111
1P0P1
1C001
1E001
11111
