11111
100C1
1C001
1E001
11111
